###########
#...#....##
#.#.#.##..#
#.#.#...#.#
#.#..##..##
#..#...#..#
##..##..#.#
..#...#.#.#
#..##.#.#.#
##....#...#
###########
